XXXXXXXXXXXXXXXXXXXXXXXXXXXXXXXXXXXXXXXXXXXXXXXXXXXXXXXXXXXXXXXXXXXXXXXXXXXXXXXXXXXXXXXXXXXXXXXXXXXXXXXXXXXXXXXXXXXXXXXXXXXXXXXXXXXXXXXXXXXXXXXXXXXXXXXXXXXXXXXXXXXXXXXXXXXXXXXXXXXXXXXXXXXXXXXXXXXXXXXXXXXXXXXXXXXXXXXXXXXXXXXXXXXXXXXXXXXXXXXXXXXXXXXXXXXXXXXXXXXXXXXXXXXXXXXXXXXXXXXXXXXXXXXXXXXXXXXXXXXXX
P X     X     X     X               X   X           X     X   X           X   X           X     X                     X     X           X       X           X       X             X   X                 X   X   X     X           X       X                   X               X     X       X         X     X
X X X XXX XXX X XXX X X XXX XXXXXXX XXX X XXXXXXX X X X X X X X XXX XXXXX XXX X XXX X XXXXX XXX X XXXXXXXXXXXXX X XXX X XXX XXXXXXX XXX X X XXX X XXXXXXXXX XXX XXX XXX XXX XXXXX X X XXXXXXXXX XXXXXXX X X X X X XXX X XXXXXXX X X XXXXX X XXXXXXXXXXXXXXXXX X XXXXX XXX XXX X XXX XXX XXXXX XXXXXXX X XXX X
X X X     X   X   X   X   X X   X X     X   X   X X X X X X X   X   X   X   X   X   X X     X X     X   X     X X   X   X X         X   X X X   X X   X       X X X   X   X X   X   X     X   X   X     X X   X X   X         X X X   X X X X           X   X X X   X X   X   X   X   X         X   X   X   X
X X XXXXXXX X XXX XXXXXXX XXX X X XXX XXX XXX X X X X X XXX XXXXX XXX XXXXX XXXXX XXXXX XXXXX XXXXXXX X X XXX X XXX XXXXX XXXXXXXXXXX XXXXX X XXX X X XXXXXXX X X XXX XXX XXX X XXXXXXXXX X X XXX X XXXXXXX XXX XXX XXXXXXXXXXX X XXX X X X X X XXXXXXX XXX X X X X XXX XXX XXXXX XXX XXXXXXXXX X X XXXXX X X
X X X X     X X X     X X X   X X X   X   X   X X X X X       X   X   X   X   X   X     X     X       X X X   X X   X   X   X               X X   X X       X   X   X   X     X X   X       X X   X       X   X         X       X     X X X X X   X         X X X X X   X X X   X X X     X   X   X X     X X
X X X X XXXXX X XXXXX X X X XXX X X XXX XXX XXX X X X XXXXXXXXX XXXXX X X XXX X XXX XXXXX XXXXX XXXXXXX X X XXXXX X X X X XXX XXXXXXXXX XXXXX X XXX XXXXXXX XXXXX XXXXX XXXXXXX X X X XXXXXXX X XXXXXXXXX XXX XXXXXXXXXXX XXXXXXXXXXXXX X X X XXX X XXXXXXXXX XXX X X XXX X X X X X XXXXX X X XXX XXX XXXXX X
X X X X X X         X X X   X   X   X   X X   X X X X     X     X   X   X       X   X   X X     X     X   X   X   X X X X     X       X X   X   X   X     X   X       X     X   X X     X   X X X       X   X X   X       X             X   X   X X   X   X   X   X X X   X X X X X     X   X X   X   X   X X
X X X X X X XXXXXXXXX X XXXXX XXXXX X XXX XXX X XXX XXXXX X XXXXX X XXXXXXXXXXXXX XXX X X X XXXXXXX X XXXXXXX X XXX X X XXXXXXX XXXXX XXX X XXXXX XXXXXXX XXX X XXX XXXXXXX X XXXXXXXXXXX X X X XXXXX X XXX X X X X XXXXXXX XXXXXXXXX X XXXXXXX X XXXXX X X XXX XXX X XXX X X X X XXXXX XXXXX X XXX XXX XXX X
X X X X X   X     X   X     X     X X X   X   X         X X       X X           X     X X X X       X X   X   X X   X X   X     X   X     X     X X     X   X X   X   X   X X X           X X X     X X   X X   X X X   X X X         X X X   X X     X X   X     X   X   X X X X X     X     X X   X   X   X
X X X X X XXX XXX X XXXXX X XXXXX XXX XXX X XXXXXXXXXXX X XXXXXXXXX X XXXXXXXXX XXXXXXX X X X XXXXXXX XXX X XXX X XXX XXX X XXXXXXX XXXXXXXXXXX X XXX X X XXX XXXXX X X X X X X XXXXXXXXXXX X XXX X XXX XXX XXXXX X X X X X X XXXXXXXXX X X X X XXXXX X XXXXXXXXX XXXXX X X X X X X X XXX XXXXXXX XXX X X XXX
X X   X X X   X   X     X X X   X   X X   X X         X X X       X X X   X   X   X       X X X   X   X   X X   X X   X X   X       X         X   X   X X   X X   X X   X X X       X       X   X X   X   X     X X   X X X X     X X   X X X   X   X   X         X X   X X X X   X X X   X       X   X X X X
X XXX X XXX XXX XXXXXXX X X X XXXXX X X XXX XXXXXXXXX X X X X XXXXX X X XXX X X X X XXXXXXX X X X X XXX X X X XXX X XXX XXXXXXXXX X X X XXXXXXXXXXX XXX XXX X X X XXXXX X X XXXXXXX X XXXXXXXXX XXXXX X X XXXXX XXX XXX X X XXXXX X X XXX X XXXXXXX XXXXX XXXXXXXXX X X X X X XXXXX XXX XXX XXXXXXX XXX X X X
X X   X X   X   X     X X X X     X   X   X X       X   X   X X     X   X   X   X X X       X X X       X X   X   X X X       X   X X X             X       X   X     X X         X X     X   X     X X X     X   X X   X X   X   X X X   X   X   X         X   X     X X X X   X       X   X     X X   X X X
X X XXX X XXX X X XXX X X X X X XXXXXXXXX X X XXXXX X XXXXXXX X XXX XXX X X XXXXXXX X XXXXXXX XXX XXXXXXX XXXXX XXX X X X XXX X XXX X XXXXXXXXXXX XXXXXXXXX XXXXXXXXX XXXXXXXXXXX XXX XXX X X XXXXX X XXXXX X XXX XXX XXX X XXX XXX X X X XXX X X X XXXXXXX X X X XXXXX XXX X X X XXXXXXX XXX XXX X XXXXX X X
X   X   X X   X X X X X   X X X     X     X X     X X     X   X   X   X X X X   X   X   X       X   X   X   X   X   X   X X   X   X X           X X   X   X   X     X     X         X X   X X   X X X   X   X   X X   X     X   X X   X X   X   X X X     X   X X   X   X   X X X X       X   X X X X     X X
X XXX XXX X XXX X X X XXXXX X XXX X X XXXXX X XXXXX XXXXXXX XXXXX XXX X X XXX X X XXXXX XXXXXXX X XXX X XXX X XXX XXXXXXX XXX XXX X XXXXXXX XXXXX X X XXX XXX X XXX XXXXX XXXXXXXXX XXX XXX XXX X X XXX X XXX XXX X XXX XXXXX XXX X XXX XXX XXXXX X XXX X XXXXX XXXXX XXX XXXXX X XXXXXXX X X X X X X XXXXX X
X X   X   X X   X   X     X X X   X   X   X   X     X     X     X X X X X     X X X   X     X   X X   X   X X X X       X   X X   X   X X   X   X X X   X   X X X       X   X   X       X     X   X   X X X   X   X   X X X   X   X X     X X     X X   X X   X X   X   X   X   X   X   X X X X     X X     X
X X XXX XXX XXXXX XXX XXXXX X X XXXXXXX X XXXXX XXX X XXX XXX XXX X X X XXXXXXX X X XXXXXXX X XXX X XXXXX XXX X XXXXXXX XXX X X XXXXX X X XXX X X X XXX X X X X X XXXXXXX X X X XXXXXXXXXXXXX XXX XXX X X XXXXX XXXXX X X X XXXXX X XXXXXXX X XXXXX X XXX X X X X X XXX XXX X XXXXX X X X X X XXXXXXX XXX X X
X X X   X X X     X   X     X X X   X   X X     X X X X X     X   X   X X     X   X   X     X X X X   X X   X   X     X     X   X X   X     X X X   X   X X X X X X     X X   X   X           X     X   X X     X     X   X X     X       X X X   X   X   X X X X X   X       X     X X   X X   X   X X   X X
X X X XXX X X XXXXX X X XXXXXXX X X X XXX X XXXXX X X X XXXXXXX XXXXX X XXX X XXXXXXX X XXXXX X X XXX X XXX XXX X XXXXXXXXXXXXXXX X XXXXXXXXX X XXXXX XXX XXX XXX X XXX X XXXXXXX X XXXXXXXXXXXXXXXXXXXXX X XXXXX XXXXXXX X X X XXXXXXXXX X X X XXXXXXX XXX X X X XXX XXXXXXXXXXXXX X XXXXXXXXX X X X X XXX X
X X   X   X   X   X X X X     X   X   X X X   X   X X X       X     X X   X X X     X X X     X     X X   X     X         X       X       X   X X     X         X X X   X   X     X X                     X   X   X X     X X X   X     X X X X X   X   X   X X   X   X           X   X         X X   X   X X
X XXXXX X XXXXXXX X XXX X XXX X XXXXXXX X XXX XXX X X X XXXXXXXXXXX X XXX X X X X X X X XXX XXX XXXXX X X XXXXXXXXXXXXXXX X X XXXXXXXXXXX X XXX X XXXXXXXXXXXXX X X X XXXXXXX XXXXX X XXXXXXXXXXXXXXXXX X XXX X XXX X XXXXX X XXX X X X X X X X X X X XXX XXX XXXXX XXX XXXXXXXXX XXXXXXX XXX XXX XXXXXXX XXX
X X     X         X     X X X X       X X   X   X   X X           X X   X X X   X X   X   X   X X     X X X   X         X X X         X   X X   X   X   X     X   X X X     X X     X X         X     X X   X X X X   X     X   X X X X X   X X   X X X   X X X   X   X   X     X X       X   X   X     X   X
X XXX XXXXXXX XXXXXXXXXXX X X XXXXXXX X X XXXXX XXX X X XXXXXXX X X XXXXX X XXXXX XXX XXX X X XXX XXXXX X X X XXX XXXXX X X XXXXX XXX X XXX X XXXXX X X X XXX X XXX X X XXX X X X XXX X XXXXX XXX XXX X XXX X X X X XXX XXXXXXX X X X XXXXX X XXX X X X XXX X X XXXXX XXX XXXXX X X XXX XXX XXX XXXXX X X X X
X   X X     X             X   X       X X     X   X X X       X X X       X X X   X     X X X   X X     X X X     X       X X   X   X X     X   X   X X   X X X X   X   X   X X X   X X X     X   X X X   X X X X     X X     X X   X       X   X X X   X X   X X       X X     X X X   X   X   X     X X X X
XXX X XXXXX XXXXXXXXXXX XXX XXX XXXXXXX XXX XXXXX XXX XXXXXXXXX XXXXXXXXXXX X X XXXXXXX X X XXX X X XXXXX X XXXXXXX XXXXXXX X XXXXX XXXXX XXXXX X XXX XXXXX X XXX XXXXXXX XXX X XXX X X X XXXXX XXX X XXX X X X X XXXXX X X XXX XXXXXXXXXXXXXXX XXX XXXXX X XXX X XXX XXX X XXXXX X X XXX XXX XXX XXXXX XXX X
X   X X     X     X     X     X X   X   X X     X   X     X   X     X     X X X   X   X X X   X     X   X   X     X   X     X     X     X X   X   X   X       X   X X   X   X X   X   X X X   X   X       X X   X   X   X X X     X     X     X   X     X   X   X   X X   X   X   X X X     X X   X   X X   X
X XXX X XXX XXX X X XXXXXXXXX X X X X X X XXX X XXX XXXXX X X XXXXX X X XXX X XXX X X XXX X XXXXX XXX X XXXXX XXX XXX X XXXXX XXX XXX XXX X X XXX X XXXXX XXXXX XXX X X XXX X XXX XXXXXXX X X XXX XXXXXXXXXXXXXXXXX X XXX X X XXXXX XXX X XXX XXX X XXX X XXXXX XXX XXX XXXXX X XXXXX XXXXX X X XXX XXX X XXX
X   X X   X   X X X X     X X X X X   X   X X X   X     X X X       X X   X X   X X X X   X X   X X   X         X   X X     X X   X X     X X   X X     X X   X X X   X   X X X   X       X X   X X   X           X X   X X   X   X   X   X X   X X X X X   X   X X   X   X   X X     X   X X X   X   X X   X
XXX X XXX XXX X X X X XXX X X X X XXXXXXX X X XXX XXX XXX X XXXXXXXXX XXX X X X X X X X XXXXX X X X XXXXXXXXXXXXX X XXXXXXX X X X X XXXXXXX XXX XXXXXXX X X X X X X XXX X X X X XXX XXXXX X XXX X X X X XXX XXXXXXX XXX XXXXXXX X XXX XXXXX X X X X X X XXX X X X XXX XXX X XXX X XXX X X X X XXX X X X XXX X
X   X     X X X X X   X   X   X   X     X   X X     X X   X   X     X X X   X X X   X X       X X X X X     X   X X X       X X X   X     X   X       X X   X X X   X   X X   X   X X   X X   X   X X   X X       X   X         X           X X X X X X   X   X     X   X   X   X X   X X X X     X X X     X
X XXXXXXXXX X X XXXXXXX XXX XXXXXXX XXX XXX X XXXXXXX X XXXXX X XXX X X XXXXX X XXXXX XXXXXXXXX XXX X X XXX X X XXX X XXXXXXXXX XXX X X X XXX XXXXXXX X XXXXX X X XXX XXX XXXXXXX X X X X XXX XXX X XXXXX XXXXXXX XXX XXXXXXXXXXXXXXXXXXXXX X XXX X X X XXX XXXXXXXXXXX XXX X XXX XXX X X XXXXXXXXX X XXXXX X
X X       X   X       X   X     X     X   X X       X X     X X   X   X   X   X X     X       X       X X     X     X           X X X X X X X     X     X   X   X   X X   X   X   X X X X X X X   X   X     X     X X   X X       X     X   X X   X   X     X       X   X   X X     X X X     X     X     X X
X X X XXX X XXXXXXX XXXXX XXXXX X XXXXX XXX XXXXXXX X XXXXX X XXX XXXXXXX X XXX X XXX XXX XXX XXXXXXXXX X XXXXX XXXXXXXXXXXXXXXXX X XXX X X XXXXX X XXXXX X XXXXXXXXX XXX XXX X XXX X XXX X X XXXXXXX XXX XXX XXX X XXX X X XXXXX X XXX XXXXX X XXXXXXXXXXXXX XXXXX X XXX XXX XXXXX X X XXX X X XXXXX XXXXX X
X X X X X X       X X     X   X X   X   X   X X     X     X X           X X X   X   X     X X     X     X X   X X       X         X     X   X   X X X   X X X       X   X     X   X X   X   X       X   X   X   X   X   X     X   X   X     X X     X       X X   X X       X X     X X   X X X X   X       X
X XXX X X XXXXXXX X X XXXXX XXX XXXXX XXX XXX X X XXXXXXX X XXXXXXXXXXX X X X X XXX XXXXXXX XXXXX X XXX XXX X XXX X XXX X XXXXX XXXXXXXXXXX X XXX X X X X X X XXXXX XXX XXXXX XXX X XXX XXX XXXXXXX XXX XXX XXX XXX X XXXXXXXXX XXXXX XXXXX X XXXXX X XXXXX X X XXX XXXXXXXXX X XXXXX XXX X XXX XXX XXXXXXXXX
X     X   X     X   X X   X   X     X         X X X     X X   X   X X   X   X X   X     X       X X X   X   X     X   X X   X X           X   X   X X X   X   X   X   X   X     X X   X X   X     X   X   X   X X   X     X     X   X X   X X   X   X     X   X   X     X   X X     X X   X   X     X       X
XXXXXXX XXX XXX XXX X X X XXX XXXXX XXXXXXXXXXX X X XXX X XXX X X X X XXX XXX XXX XXXXX XXXXX XXX X X XXX XXXXXXXXXXX XXXXX X XXXXXXX XXXXXXX X XXX X XXXXXXXXX XXXXX X X XXXXXXX XXX X X XXXXX X XXX XXX X X X XXXXXXXXX X XXX X X X X XXX X XXX XXX XXX XXXXXXX XXXXX X X X X XXX XXX XXXXX XXXXX XXX XXX X
X X   X X X   X   X X   X   X X     X           X X   X   X   X X X   X   X   X   X   X     X     X X   X X     X   X     X X     X   X       X   X X     X     X   X X X   X     X   X X X   X X   X     X X X X       X   X   X X   X   X X   X   X   X X     X     X   X   X X   X   X X       X   X X   X
X X X X X XXX XXX X XXXXXXX X X XXXXX XXXXXXXXXXX XXX XXX X XXX X X XXXXXXX XXX XXXXX XXXXX XXXXXXX XXX X X X X X XXXXX X X X XXXXX X X XXXXXXXXX X XXXXX XXX X X X X XXX X X XXXXX XXX X X X XXXXX XXXXXXX X X X XXXXX XXXXX XXX XXXXX X X XXX XXX XXX X X XXX X XXX XXXXXXXXX X XXX XXX X XXXXXXXXX X X XXX
X   X X X       X         X X X X               X   X   X X   X X X     X   X           X X       X X   X X X X   X     X X   X     X X X     X   X     X     X X X X   X X X   X     X     X     X   X     X X   X   X     X   X X   X X         X X   X     X X   X       X   X     X   X   X       X X X X
X XXX X XXXXXXXXXXXXXXXXX X X X XXXXXXX XXXXXXX XXXXXXX XXXXX X X XXXXX X XXXXXXX XXXXX X XXXXXXX X XXXXX X X XXXXX XXXXX XXX X XXXXX X XXXXX X XXXXXXXXXXXXX XXX X XXX X X XXX XXX X XXXXXXXXXXX X X X XXX X XXXXX X X XXXXX XXX X XXX XXXXXXX XXX XXXXXXXXXXX X X XXXXXXXXX XXXXXXXXXXX XXX X XXXXXXX X X X
X X   X     X   X     X X X X   X     X X     X       X     X   X   X   X X   X   X   X   X   X   X X     X X     X   X   X   X   X   X   X   X X     X     X X   X   X X X   X   X X   X       X X X X X   X X     X X   X   X   X     X   X   X   X   X   X   X X   X     X X   X         X   X       X   X
X X XXXXXXX X X X XXX X X X X XXX XXX X X XXXXX XXXXX XXX XXXXXXXXX XXX X X X XXXXX X XXXXX X X XXX X XXXXXXX XXX XXX X XXX XXXXX XXXXXXX X XXX X XXX X X XXX X XXXXX X XXX XXXXX XXX X XXXXX X X X X X X XXX XXXXX X XXX X XXX XXX XXXXX X X XXX XXX X X X X XXXXXXX X XXX X X X X XXXXXXX XXXXX X XXXXXXX X
X X X     X   X   X X X   X X     X   X   X   X     X   X         X   X   X X       X   X   X X X   X X     X X     X X X   X   X   X   X X   X X X X   X X   X X   X X   X     X   X X   X   X X X X   X X X X   X X   X X   X   X     X X X   X     X   X X     X   X   X   X X X   X   X X     X X     X X
X X X XXX XXXXXXXXX X XXXXX XXXXXXX XXXXXXX X XXXXXXX X XXX XXXXXXXXX XXXXX XXXXXXXXXXX X XXX X X XXX X XXX XXX XXX X XXX XXXXX XXX X X X XXX X X X XXXXX X XXX XXX X XXX X X XXXXX XXXXX X XXXXX XXXXXXX X X X X XXXXX X XXX XXX XXXXXXX X XXXXXXXXXXXXXXX XXXXX X XXXXX XXXXX X XXX X X X XXXXXXX X XXX X X
X X     X                   X               X         X   X                 X             X     X       X       X   X             X   X       X         X     X   X       X X             X               X     X       X       X         X                       X             X     X X           X   X   K
XXXXXXXXXXXXXXXXXXXXXXXXXXXXXXXXXXXXXXXXXXXXXXXXXXXXXXXXXXXXXXXXXXXXXXXXXXXXXXXXXXXXXXXXXXXXXXXXXXXXXXXXXXXXXXXXXXXXXXXXXXXXXXXXXXXXXXXXXXXXXXXXXXXXXXXXXXXXXXXXXXXXXXXXXXXXXXXXXXXXXXXXXXXXXXXXXXXXXXXXXXXXXXXXXXXXXXXXXXXXXXXXXXXXXXXXXXXXXXXXXXXXXXXXXXXXXXXXXXXXXXXXXXXXXXXXXXXXXXXXXXXXXXXXXXXXXXXXXXXXX
